18 15
##################
#...****##****...#
#...**********...#
#*******##*******#
#****************#
#....********....#
#....#..##..#....#
#....*..**..*....#
#....#......#....#
#....##****##....#
#...*...##...*...#
#****************#
#.......##.......#
#.......**.......#
##################
