18 15
##################
#................#
#................#
#................#
#..##..###....#..#
#.#..#.#......#..#
#.#....##.....#..#
#.#.##.#......#..#
#.#..#.#......#..#
#..###.#...#..#..#
#....#.###..##...#
#................#
#................#
#................#
##################
