18 15
##################
#..*.......*.....#
#.*......*....*..#
#...*.........**.#
#.*...*.##.......#
#....#....*..*...#
#....#*..#.......#
#....*...*...*...#
#....*...*..*....#
#....#...*...*...#
#...*.*..#.......#
#...*....*.*..*..#
#..*.#......**...#
#........#.......#
##################
