18 15
##################
#..************..#
#.**************.#
#***#.#.#..#.#***#
#***#.#.#..#.#***#
#***#.#.#..#.#***#
#***#.#.#..#.#***#
#***#........#***#
#***#.#.#..#.#***#
#***#.#.#..#.#***#
#***#.#.#..#.#***#
#***#.#.#..#.#***#
#.**************.#
#..************..#
##################