18 15
##################
#................#
#........*....*..#
#.............**.#
#....#####.......#
#....#....*......#
#....#*..........#
#....*.......*...#
#....#...........#
#....#####.......#
#...*....#.......#
#........#.*.....#
#........#.......#
#........#.......#
##################
