18 15
##################
#..************..#
#.**************.#
#***####..####***#
#***#........#***#
#***#...**...#***#
#***#...**...#***#
#***#...**...#***#
#***#...**...#***#
#***#...**...#***#
#***#........#***#
#***####..####***#
#.**************.#
#..************..#
##################
